Rk,,Age,G,GS,MP,FG,FGA,FG%,3P,3PA,3P%,2P,2PA,2P%,eFG%,FT,FTA,FT%,ORB,DRB,TRB,AST,STL,BLK,TOV,PF,PTS
1,Trae Young\youngtr01,20,81,81,2503,525,1256,.418,156,482,.324,369,774,.477,.480,343,414,.829,64,237,301,653,72,15,308,140,1549
2,Kevin Huerter\huertke01,20,75,59,2048,275,657,.419,136,353,.385,139,304,.457,.522,41,56,.732,60,185,245,214,65,25,109,155,727
3,DeAndre' Bembry\bembrde01,24,82,15,1931,275,616,.446,50,173,.289,225,443,.508,.487,87,136,.640,54,304,358,202,105,41,142,190,687
4,John Collins\collijo01,21,61,59,1829,465,831,.560,55,158,.348,410,673,.609,.593,203,266,.763,219,376,595,121,22,39,120,199,1188
5,Kent Bazemore\bazemke01,29,67,35,1643,278,691,.402,96,300,.320,182,391,.465,.472,127,175,.726,37,224,261,152,89,42,121,170,779
6,Dewayne Dedmon\dedmode01,29,64,52,1609,259,526,.492,83,217,.382,176,309,.570,.571,92,113,.814,105,375,480,90,69,71,84,214,693
7,Taurean Waller-Prince\princta02,24,55,47,1552,262,594,.441,123,315,.390,139,279,.498,.545,95,116,.819,22,177,199,118,53,19,100,141,742
8,Alex Len\lenal01,25,77,31,1544,320,648,.494,74,204,.363,246,444,.554,.551,140,216,.648,158,266,424,86,27,69,97,200,854
9,Vince Carter\cartevi01,42,76,9,1330,196,468,.419,123,316,.389,73,152,.480,.550,47,66,.712,31,163,194,87,44,27,48,141,562
10,Jeremy Lin\linje01,30,51,1,1003,180,386,.466,44,132,.333,136,254,.535,.523,142,168,.845,16,103,119,181,38,7,98,96,546
11,Omari Spellman\spellom01,21,46,11,805,98,244,.402,44,128,.344,54,116,.466,.492,32,45,.711,72,122,194,47,26,25,31,67,272
12,Justin Anderson\anderju01,25,48,4,463,64,157,.408,24,77,.312,40,80,.500,.484,26,35,.743,24,60,84,23,22,13,23,48,178
13,Jaylen Adams\adamsja01,22,34,1,428,38,110,.345,25,74,.338,13,36,.361,.459,7,9,.778,11,49,60,65,14,5,28,45,108
14,Alex Poythress\poythal01,25,21,1,305,40,81,.494,9,23,.391,31,58,.534,.549,18,29,.621,29,47,76,17,4,10,13,47,107
15,Tyler Dorsey\dorsety01,22,27,0,251,32,89,.360,10,39,.256,22,50,.440,.416,16,26,.615,9,34,43,17,7,1,10,20,90
16,Daniel Hamilton\hamilda02,23,19,3,204,23,60,.383,8,23,.348,15,37,.405,.450,3,6,.500,10,37,47,22,6,1,16,19,57
17,Miles Plumlee\plumlmi01,30,18,0,173,32,48,.667,0,0,,32,48,.667,.667,16,30,.533,16,23,39,17,6,4,10,14,80
18,Deyonta Davis\davisde01,22,9,0,118,15,22,.682,0,1,.000,15,21,.714,.682,6,10,.600,10,26,36,5,3,5,3,12,36
19,Isaac Humphries\humphis01,21,5,1,56,6,21,.286,3,11,.273,3,10,.300,.357,0,0,,4,7,11,0,1,0,0,7,15
20,B.J. Johnson\johnsbj01,23,6,0,43,8,16,.500,3,6,.500,5,10,.500,.594,2,2,1.000,2,6,8,0,2,0,2,3,21
21,Tyler Zeller\zellety01,29,2,0,11,0,2,.000,0,1,.000,0,1,.000,.000,0,0,,2,4,6,1,0,0,0,4,0
22,Jordan Sibert\siberjo01,26,1,0,4,1,1,1.000,1,1,1.000,0,0,,1.500,0,0,,0,0,0,0,0,0,0,0,3
,Team Totals,,82,,19855,3392,7524,.451,1067,3034,.352,2325,4490,.518,.522,1443,1918,.752,955,2825,3780,2118,675,419,1397,1932,9294